0 0 0 0 0 0 0 0 0 0 0 0 0 0 0 0 0 0 0 0 
0 0 0 0 0 0 0 0 0 0 0 1 1 1 1 1 1 1 1 0 
0 0 0 0 0 0 0 0 0 0 0 0 0 0 0 0 0 0 1 0 
0 0 0 0 0 0 0 0 0 0 0 0 0 0 0 0 0 0 1 0 
0 0 0 0 0 0 1 1 1 1 1 1 1 1 1 1 1 1 1 0 
0 0 0 0 0 0 1 0 0 0 0 0 0 0 0 0 0 0 1 0 
0 0 0 0 0 3 1 0 1 1 1 1 1 1 1 1 1 0 1 0 
0 0 0 0 0 0 1 0 1 1 1 1 1 1 1 1 1 0 1 0 
4 0 0 0 0 0 0 0 0 0 1 1 1 0 0 0 1 0 1 0 
0 0 0 1 0 0 1 1 1 0 3 0 1 0 0 0 1 0 1 0 
4 0 0 0 0 0 4 4 1 0 3 0 0 0 0 0 1 0 1 0 
0 0 0 0 0 0 1 4 1 0 2 0 1 0 0 0 1 0 1 0 
0 0 0 0 0 0 1 4 1 1 1 0 1 1 0 0 1 0 1 0 
1 1 1 2 1 1 1 4 1 0 0 1 0 0 1 0 0 0 1 0 
2 2 2 0 1 0 4 0 3 0 0 0 0 0 0 0 0 0 1 0 
2 1 1 1 1 0 1 0 1 0 0 1 0 0 1 0 0 0 1 0 
2 2 2 0 1 0 1 0 1 0 0 0 0 0 0 3 0 0 1 11
1 1 1 2 1 4 1 3 1 0 0 0 0 0 0 0 0 0 1 10 
5 6 7 0 0 0 0 0 1 1 0 0 0 0 0 0 0 0 1 9 
1 1 1 1 1 1 1 1 1 1 1 1 1 1 1 1 1 1 1 1 
0