0 0 0 0 0 0 1 0 0 0 0 0 0 1 0 0 0 0 0 0 
9 0 0 0 0 0 1 10 0 0 0 0 0 1 11 0 0 0 0 0 
1 0 0 0 0 0 1 1 0 0 0 0 0 1 1 0 0 0 0 0 
0 0 0 0 0 0 1 0 0 0 0 0 0 1 0 0 0 0 0 0 
0 0 0 0 0 0 1 0 0 1 0 0 0 1 0 0 0 0 0 0 
0 0 0 1 0 0 1 0 0 0 0 0 0 1 1 0 0 0 0 0 
0 0 0 0 0 0 1 0 0 0 0 1 1 1 1 1 0 0 0 0 
0 0 0 0 0 0 1 0 0 0 0 0 0 1 0 0 0 0 0 0 
1 1 1 0 1 1 1 0 0 1 0 0 0 1 0 0 0 0 0 0 
0 0 0 0 0 0 1 0 0 0 0 0 0 1 0 0 1 0 0 0 
0 0 0 0 0 0 1 0 0 0 0 0 0 1 0 0 0 0 0 0 
0 0 0 1 0 0 1 0 0 0 1 0 0 1 0 0 0 0 0 0 
0 0 0 0 0 0 1 0 0 0 0 0 0 1 0 0 0 0 1 1 
0 0 0 0 0 0 1 1 1 0 0 0 0 1 0 0 0 0 0 0 
1 1 0 0 0 0 1 0 0 0 0 0 0 1 1 1 0 0 0 0 
0 0 0 0 0 0 1 0 0 0 0 1 1 1 0 0 0 0 0 0 
0 0 0 0 1 1 1 0 0 0 0 0 0 1 0 0 0 0 0 0
0 0 0 0 1 1 1 1 0 0 0 0 0 1 0 0 1 0 0 0 
0 5 0 0 1 1 1 1 0 6 0 0 0 1 0 0 1 0 0 7 
1 1 1 1 1 1 1 1 1 1 1 1 1 1 1 1 1 1 1 1 
0