0 0 0 0 0 0 0 0 0 0 0 0 0 0 0 0 0 0 0 0 
0 0 0 0 0 0 0 0 0 0 0 0 0 0 0 0 0 0 0 0 
0 0 0 0 0 0 0 0 0 0 0 0 0 0 0 0 0 0 0 0 
0 0 0 0 0 0 0 0 0 0 0 0 0 0 0 0 0 0 0 0 
0 0 0 0 0 0 0 0 0 0 0 0 0 0 0 0 0 0 0 0 
0 0 0 0 0 0 0 0 0 0 0 0 0 0 0 0 0 0 0 0 
0 0 0 0 0 0 0 0 0 0 0 0 0 0 0 0 0 0 0 0 
0 1 0 0 0 0 0 0 0 0 0 0 0 0 0 0 0 0 0 0 
0 1 0 0 0 0 0 0 0 0 0 0 0 0 0 0 0 0 0 0 
0 1 0 0 0 0 0 0 0 0 0 0 0 0 0 0 0 0 0 0 
0 1 0 0 0 0 0 0 0 0 0 0 0 0 0 0 0 0 0 0 
0 1 0 0 0 0 0 0 0 0 0 0 0 0 0 0 0 0 0 0 
0 1 0 0 0 0 0 0 0 0 0 0 0 0 0 0 0 0 0 0 
0 1 0 0 0 0 0 0 0 0 0 0 0 0 0 0 0 0 0 0 
0 1 0 0 0 0 0 0 0 0 0 0 0 0 0 0 0 0 0 0 
0 1 1 1 1 1 1 1 1 1 1 1 1 1 1 1 1 0 0 0 
7 1 0 0 0 0 0 0 0 0 0 0 0 0 0 0 0 0 0 0 
6 3 0 0 0 0 0 0 0 0 0 0 0 0 0 0 0 0 0 0 
5 4 0 0 0 0 0 0 0 0 0 0 0 0 0 0 0 9 10 11 
1 1 1 1 1 1 1 1 1 1 1 1 1 1 1 1 1 1 1 1 
32
Spike/4 18/0/g
Spike/5 18/0/g
Spike/6 18/0/g
Spike/5 18/0/g
Spike/6 18/0/g
Spike/7 18/0/g
Spike/8 18/0/g
Spike/9 18/0/g
Spike/10 18/0/g
Spike/11 18/0/g
Spike/12 18/0/g
Spike/13 18/0/g
Spike/14 18/0/g
Spike/15 18/0/g
Spike/4 14/0/n
Spike/5 14/0/n
Spike/6 14/0/n
Spike/5 14/0/n
Spike/6 14/0/n
Spike/7 14/0/n
Spike/8 14/0/n
Spike/9 14/0/n
Spike/10 14/0/n
Spike/11 14/0/n
Spike/12 14/0/n
Spike/13 14/0/n
Spike/14 14/0/n
Spike/15 14/0/n
Spike/16 14/0/n
Spike/3 14/0/n
Spike/2 14/0/n
Spike/1 14/0/n