0 0 0 0 0 0 0 0 0 0 0 0 0 0 0 0 0 0 0 1 
0 0 0 0 0 0 0 0 0 0 0 0 0 0 0 0 0 0 8 1 
0 0 0 0 0 0 0 0 1 1 1 1 1 1 1 1 1 1 1 1
0 0 0 0 1 0 0 0 0 0 0 0 0 0 0 0 0 0 0 1 
0 0 0 0 1 0 0 0 0 0 0 0 0 0 0 0 0 0 0 1 
5 0 0 0 1 0 0 0 0 0 0 0 0 0 0 0 0 0 0 1
1 1 1 1 1 1 1 1 1 1 1 1 1 1 1 1 1 1 1 1 
0 0 0 0 0 0 0 0 0 0 0 0 0 0 0 0 0 0 0 1 
0 0 0 0 0 0 0 0 0 0 0 0 0 0 0 0 0 0 8 1 
0 0 0 0 0 0 0 0 1 1 1 1 1 1 1 1 1 1 1 1
0 0 0 0 0 0 0 0 0 0 1 1 1 1 1 1 1 1 1 1 
0 0 0 0 0 0 0 0 0 0 1 1 1 1 0 0 0 0 0 0 
6 0 0 0 0 0 0 0 1 1 1 1 1 1 1 1 1 1 1 1
1 1 1 1 1 1 1 1 1 1 1 0 0 0 0 0 0 0 0 1  
0 0 0 0 0 0 1 0 0 0 1 0 0 0 0 0 0 0 8 1 
0 0 0 0 0 0 1 0 0 0 1 0 0 0 0 1 1 1 1 1
0 0 0 0 1 0 1 0 1 0 1 1 1 0 0 0 0 0 0 1 
0 0 0 0 1 0 1 0 1 0 1 0 0 0 0 0 0 0 0 1 
7 0 0 0 1 0 0 0 1 0 0 0 0 0 0 0 0 0 0 1
1 1 1 1 1 1 1 1 1 1 1 1 1 1 1 1 1 1 1 1 
4
Text/5 25/0 0 300 180/0 0 0 255/20/Use WASD
Text/5 235/0 280 300 180/0 0 0 255/20/Use IJKL
Text/5 445/0 450 300 180/0 0 0 255/20/Use Arrow Keys
Text/435 350/300 0 300 600/0 0 0 0/20/Reach the Exits