1 1 0 0 0 0 0 0 0 3 3 0 0 1 0 0 0 0 0 1 
1 1 0 0 0 0 0 0 0 3 3 0 0 1 0 0 0 0 9 1 
1 1 0 0 0 0 0 0 0 3 3 0 0 1 0 0 0 0 1 1 
1 1 0 0 0 0 0 0 0 3 3 0 10 1 0 0 0 0 0 1 
1 1 2 0 0 0 0 0 0 1 1 1 1 1 1 0 0 0 0 1 
1 1 0 0 0 0 0 0 0 1 1 0 0 0 0 0 0 0 0 1 
1 1 0 0 0 0 0 0 0 1 1 0 0 0 0 4 0 0 0 1 
1 1 2 0 0 0 0 0 0 1 1 0 0 0 0 0 0 0 0 1 
1 1 0 0 0 0 0 0 0 1 1 0 4 0 0 0 0 0 11 1 
1 1 0 0 0 0 0 0 0 1 1 0 4 0 0 0 0 0 2 1 
1 1 2 0 0 0 0 0 0 1 1 0 4 0 0 0 0 0 0 1 
1 1 0 0 0 0 0 0 0 2 0 0 4 0 0 0 0 0 0 1 
1 1 0 0 0 0 0 0 0 2 0 1 1 0 0 0 0 0 0 1 
1 1 2 0 0 0 0 0 0 0 3 1 0 0 0 0 0 0 1 1 
1 1 0 0 0 0 0 0 0 0 0 1 0 0 0 0 0 0 0 1 
1 1 0 0 0 0 0 0 0 0 0 1 0 0 0 0 0 0 0 1 
1 1 3 0 0 0 0 0 0 0 2 1 0 0 0 0 0 0 1 1 
1 1 0 0 0 0 0 0 0 0 0 1 0 0 0 0 0 0 0 1
1 1 5 0 0 0 0 0 0 0 6 1 0 0 0 0 0 0 7 1 
1 1 1 0 0 0 0 0 0 0 1 1 0 0 0 0 0 0 1 1
0
