0 0 0 0 0 0 0 0 0 0 0 0 0 0 0 0 0 0 0 0 
0 0 0 0 0 0 0 0 0 0 0 0 0 0 0 0 0 0 0 0 
0 0 0 0 0 0 0 0 0 0 0 0 0 0 0 0 0 0 0 0 
0 0 0 0 0 0 0 0 0 0 0 0 0 0 0 0 0 0 0 0 
0 0 0 0 0 0 0 0 0 0 0 0 0 0 0 0 0 0 0 0 
0 0 0 0 0 0 0 0 0 0 0 0 0 0 0 0 0 0 0 0 
0 0 0 0 0 0 0 0 0 0 0 0 0 0 0 0 0 0 0 0 
0 0 0 0 0 0 0 0 0 0 0 0 0 0 0 0 0 0 0 0 
0 0 0 0 0 0 0 0 0 0 0 0 0 0 0 0 0 0 0 0 
0 0 0 0 0 0 0 0 0 2 2 0 0 0 2 2 0 0 0 0 
0 0 0 0 0 0 0 0 0 0 0 0 0 0 0 0 0 0 0 0 
0 0 0 11 0 0 0 0 0 0 0 0 0 0 0 0 0 0 0 0 
2 2 1 1 1 1 1 1 1 4 4 1 1 1 1 1 1 0 0 0 
0 0 3 0 0 0 0 0 0 0 0 0 0 0 0 0 1 0 0 0 
0 0 3 0 0 0 0 0 0 3 3 0 0 0 0 0 1 0 0 0 
0 0 1 0 0 0 0 0 0 0 0 0 0 0 0 0 1 0 0 0 
2 0 1 0 0 0 0 0 0 0 0 0 0 0 0 0 1 0 0 4 
0 0 2 0 0 0 0 0 0 0 0 0 0 0 0 0 1 0 0 0 
0 0 2 0 0 0 0 0 0 5 0 6 0 7 0 0 4 0 0 0 
1 1 1 1 1 1 1 1 1 1 1 1 1 1 1 1 1 1 1 1 
14
Spike/3 18/0/r
Spike/4 18/0/r
Spike/5 18/0/r
Spike/6 18/0/r
Spike/5 11/0/n
Spike/6 11/0/n
Spike/7 11/0/n
Spike/8 11/0/n
Spike/9 11/0/b
Spike/10 11/0/b
Spike/11 11/0/n
Spike/12 11/0/n
Spike/13 11/0/n
Spike/14 11/0/n
Spike/12 11/0/n
