1 1 1 1 1 1 1 1 1 1 1 1 1 1 1 1 0 0 0 0 
1 1 1 1 1 1 1 1 1 1 1 1 1 1 1 1 0 0 0 0 
0 0 0 0 0 0 0 0 0 0 0 0 0 0 0 1 0 0 0 0 
0 0 1 1 1 1 1 1 1 1 1 1 1 1 0 1 0 0 0 0 
0 0 1 1 2 2 2 2 2 2 2 2 2 1 0 1 0 0 0 0 
0 0 1 1 2 2 2 1 1 1 1 1 2 1 0 1 0 0 0 0 
0 1 3 3 0 0 0 3 3 3 3 1 2 1 0 1 0 0 0 0 
0 1 3 1 2 2 2 1 1 1 3 1 2 1 4 1 0 0 0 0 
0 4 0 4 0 0 0 4 4 1 0 0 0 0 0 0 0 0 0 0 
1 1 3 1 2 2 2 1 4 1 0 0 0 0 0 0 0 0 0 0 
1 1 3 3 0 0 0 4 4 1 0 0 0 0 0 0 0 0 0 0 
1 1 1 1 0 0 0 1 1 1 0 0 0 9 0 10 0 11 0 0 
1 1 1 4 0 0 0 3 1 1 1 1 1 1 1 1 1 1 1 1 
1 4 4 4 0 0 0 3 3 3 3 0 0 0 0 0 0 0 0 0 
1 4 1 1 0 0 0 1 1 1 1 0 0 1 1 1 1 1 0 0 
1 4 1 1 2 2 2 1 4 4 4 0 0 0 0 0 1 1 0 0 
1 4 4 4 0 0 0 4 4 4 1 1 1 1 1 0 1 1 1 0 
1 1 1 1 2 2 2 1 1 1 1 1 1 1 1 0 1 1 1 0 
0 0 0 1 5 0 0 1 1 1 1 1 1 1 1 6 1 1 1 7 
1 1 1 1 1 1 1 1 1 1 1 1 1 1 1 1 1 1 1 1 
0